NO ./textures/north.xpm
SO ./textures/south.xpm
WE ./textures/west.xpm
EA ./textures/east.xpm

F 225,100,0
C 225,30,0

11111111111111111111111111111111111
10000000000000000000000000000000001
10000000000100W00100000000000000001
10000000000000000000000000000000001
11111111111111111111111111111111111