1111111111111111111
1000000000000000001
1000000100001000001
1011110010000000001
100000010010000000111
1000000000000000N0001
111111111111111111111