1111111
10P0C01
10E0101
10C0001
1111111