11111111111111111111111111111111
10P0C000000000000000000000000001
10E00010000000000000000000000001
10C00010000000000000000000000001
11111111111111111111111111111111