1111111111
1000000001
1000000001
100E000001
1000000001
101C100001
1001000P01
1000000001
1111111111