1111111111
1000000001
100000C001
100E000001
1111001111
100C000001
1000000P01
1000000001
1111111111